!!!!!!!!!!!!!!!!!!!!!!!!!!!!!!!!!!!!!!!!!!!!!!!!!!!!!!!!!!!!!!!!!!!
?                                                                 ?
?    __                                                     __    ?
?   |  |                                                   |  |   ?
?                                                                 ?
?                                                                 ?
?                                                                 ?
?                                                                 ?
?                                                                 ?
?                                                                 ?
?                                                                 ?
?                                                                 ?
?                                                                 ?
?                                                                 ?
?                                                                 ?
?                                                                 ?
?                                                                 ?
?                                                                 ?
?                                                                 ?
?                                                                 ?
?                                                                 ?
?                                                                 ?
?                                                                 ?
?                                                                 ?
?   |__|                                                   |__|   ?
?                                                                 ?
?                                                                 ?
!!!!!!!!!!!!!!!!!!!!!!!!!!!!!!!!!!!!!!!!!!!!!!!!!!!!!!!!!!!!!!!!!!!
